111111111111111111
11000C00C0C00C0001
10P00C00010C000011
110000001E10000001
101000000001000001
101000000000000001
101000000000100001
101000000000100001
101000000000100001
111111111111111111