111111111111111111111111111
100010C010C010C010C010C01E1
1C1P0010C010C010C010C010001
111111111111111111111111111