111111111111111111
1000000000C01111E1
101111111111101101
101000011000001001
1P0011011110111011
101011001110111011
101011101110001011
101000100000100011
111111111111111111